NO ./textures/wall_north.xpm
SO ./textures/wall_south.xpm
WE ./textures/wall_west.xpm
EA ./textures/wall_east.xpm
CT ./textures/ceiling.xpm

F 120,120,120

111111111111
100000000001
101111111101
100000000101
101011110101
101010000101
101011110101
100000000101
101111111101
1000N0000001
111111111111